Sinopsis
Los gobernantes del Imperio Galáctico, la fuerza del mal que domina el universo,
capturan a la princesa Leia, quien posee datos confidenciales sobre su centro de
operaciones militares, denominado "Estrella de la Muerte". Antes de su secuestro,
la Princesa transfiere la información ultrasecreta a la base de datos del robot R2-D2. 
Catalogado como un material inservible, R2-D2, junto con su compañero C3PO, son 
deportados a un planeta remoto, siendo comprados por el joven Luke Skywalker en 
el mercado negro. Debido a un hecho fortuito, Luke accede al mensaje de la 
princesa Leia, quien solicita el auxilio del veterano Caballero Jedi Obi-Wan Kenobi. 
Luke, Obi-Wan, los robots, el piloto Han Solo y el gigantesco wookiee Chewbacca 
conforman la tripulación que intentará liberar a la princesa Leia de los dominios de 
Darth Vader, la autoridad suprema del Imperio Galáctico.

Reparto

Mark Hamill: Luke Skywalker
Harrison Ford: Han Solo
Carrie Fisher: La princesse Leia Organa
Alec Guinness: Obi-Wan Kenobi
Anthony Daniels: C-3PO
Kenny Baker: R2-D2
Peter Mayhew: Chewbacca
Peter Gushing: Grand Moff Tarkin (Empire)
David Prowse: Dark Vador 
Phil Brown: Oncle Owen
Jack Purvis: le chef des Jawas
Denis Lawson: Wedge Antilles (Rouge 2)
Garrick Hagon: Biggs Darklighter (Rouge 3)
Jack Klaff: John
William Hootkins: Porkins (Rouge 6)
Don Henderson: General Tagge (Empire)
Angus MacInnes: Yellow Leader
Alan Harris (II): Guard of Leia
Derek Lyons: Guard in temple
Al Lampert: Commandant Daine Jir
Doug Beswick: Alien in Cantina
Malcolm Tierney: Lieutenant Chann Childsen
Joe Johnston: Soldier
Jon Berg: Alien in Cantina
Mark Austin: Boba Fett (Special Edition)
Leslie Schofield: Empire General
George Roubicek: Commandant Praji
Frazer Diamond: Un jawa (non crédité)
Graham Ashley: Yellow 5
George Stock: Cantina Patron
Grant McCune: Cannoneer

